28 31 1 1 14 14
1111111111111111111111111111
1000000000000000000000000001
1000000000000000000000000001
1000000000000000000000000001
1000000011000000000000000001
1000000000000000000000000001
1000010000000000000000000001
1000000001000000000000000001
1000010000000000000000000001
1000000000000000000000000001
1000000000000000000000000001
1000000000000000000000000001
1000000000000000000000000001
1000000000000000000000000001
1000000000000000000000000001
1000000000000000000000000001
1000000000000000000000000001
1000000000000000000000000001
1000000000000000000000000001
1000000000000000000000000001
1000000000000000000000000001
1000000000000000000000000001
1000000000000000000000000001
1000000000000000000000000001
1000000000000000000000000001
1000000000000000000000000001
1000000000000000000000000001
1000000000000000000000000001
1000000000000000000000000001
1000000000000000000000000001
1111111111111111111111111111