17 21 8 18 8 5
11111111111111111
10000000300000001
10000000000000001
10000011011000001
10000014441000001
10000014441000001
10000014441000001
10000011111000001
10000000000000001
10000000000000001
10000000000000001
10000000000000001
10000000000000001
10000000000000001
10000000000000001
10000000000000001
10000000000000001
10000001110000001
10000001410000001
10000000000000001
11111111111111111
