28 31 13 5 14 14
1111111111111111111111111111
1000000000000110000000000001
1311110111110110111110111131
1012210122210110122210122101
1011110111110110111110111101
1000000000000000000000000001
1011110110111111110110111101
1000000110111111110110000001
1111110110000110000110111111
2222210111110110111110122222
2222210111110110111110122222
2222210110000000000110122222
2222210110111001110110122222
1111110110100000010110111111
1000010000100000010000100001
1111110110100000010110111111
2222210110111111110110122222
2222210110000000000110122222
2222210110111111110110122222
1111110110111111110110111111
1000000000000110000000000001
1011110111110110111110111101
1011110111110110111110111101
1300110000000000000000110031
1110110110111111110110110111
1110110110111111110110110111
1000000110000110000110000001
1011111111110110111111111101
1011111111110110111111111101
1000000000000000000000000001
1111111111111111111111111111